0######00
##000###0
##.00$0##
##000#00#
###00000#
#0@0$0.0#
##00#000#
#000#####
#####0000