00000####
######00#
##.00000#
##00$#00#
###00#00#
#000$0.0#
##0@#000#
#000#####
#####0000