#########
#000000.#
#000$0###
#0#0#0###
#$0000###
#.0000###
#000000##
#0000@0##
#########